  +-----------------------------------+
  |               header              |
  +-----------------------------------+
  |                 nav               |
  +---------------------+-------------+
  |                     |             |
  |       section       |    aside    |
  |                     |             |
  |                     |             |
  | +-----------------+ |             |
  | |     article     | |             |
  | +-----------------+ |             |
  | |     article     | |             |
  | +-----------------+ |             |
  +---------------------+-------------+
  |               footer              |
  +-----------------------------------+
